W W W W W W W W W W W W W W W W W W W W W
W S S S S S S S S S S S S S S S S S S S W
W B W W W S W S W W W W W S W S W W W B W
W S S W W S S S S S W S S S S S W W S S W
W W S S W S W S W S W S W S W S W S S W W
D E E S S S W S W S W S W S W S S S E E D
W W S S W S W S W S K S W S W S W S S W W
W S S S W S W S W W W W W S W S W S S S W
W W W S W S S E E E E E E E S S W S W W W
W S S S S S W E W E W E W E W S S S S S W
W W S W W W W E W E E E W E W W W W S W W
W S S S S S W E W W W W W E W S S S S S W
W S W W W S W E E E E E E E W S W W W S W
W S S W W S W S W W W W W S W S W W S S W
W W S S W S W S S S W S S S W S W S S W W
D E E S S S S S W S P S W S S S S S E E D
W W E S W S W S S W E W S S W S W S E W W
W B S S S S S W S S S S S W S S S S S B W
W W W W W W W W W W W W W W W W W W W W W