W W W W W W W W W W W W W W W W W W W W W
W S S S S S S S S S W S S S S S S S S S W
W B W W S W W W W S W S W W W W S W W B W
W S S S S S S S S S S S S S S S S S S S W
W S W W W S W S W W W W W S W S W W W S W
W S S S S S W S S S W S S S W S S S S S W
W W W W W S W S W S W S W S W S W W W W W
D E E E W S W E E E E E E E W S W E E E D
W W W W W S E E W E E E W E E S W W W W W
E E E E E S E W E E K E E W E S E E E E E
W W W W W S E E W E W E W E E S W W W W W
D E E E E S W E E E E E E E W S E E E E D
W W W W W S W W W W W W W W W S W W W W W
W S S S S S S S S S P S S S S S S S S S W
W B W W S W W W W S W S W W W W S W W B W
W S W S S S S S S S S S S S S S S S W S W
W S W S W W W S W W W W W S W W W S W S W
W S S S S S S S S S S S S S S S S S S S W
W W W W W W W W W W W W W W W W W W W W W