W W W W W W W W W W W W W W W W W W W W W
W S S S S S S S S S S S S S S S S S S S W
D E W E W W W E W W W W W E W W W E W E D
W S W S W W W E W W W W W E W W W S W S W
W S W S W S S S S S K S S S S S W S W S W
W S W S W S W W W S W S W W W S W S W S W
W S W S E S W S S S S S S S W S E S W S W
W S W S W S W S W W E W W S W S W S W S W
W S W S W S S S W E E E W S S S W S W S W
W B W S W W W S E E P E E S W W W S W B W
W S W S W S S S W E E E W S S S W S W S W
W S W S W S W S W W E W W S W S W S W S W
W S W S E S W S S S S S S S W S E S W S W
W S W S W S W W W S W S W W W S W S W S W
W S W S W S S S S S W S S S S S W S W S W
W S W S W W W E W W W W W E W W W S W S W
D E W E W W W E W W W W W E W W W E W E D
W S S S S S S S S S S S S S S S S S S S W
W W W W W W W W W W W W W W W W W W W W W